1,1,1,1,1,1,1,1,1,1
1,E,2,1,1,1,1,1,1,1
1,1,2,1,1,1,1,1,1,1
1,1,2,2,1,1,1,1,1,1
1,1,1,2,1,1,1,1,1,1
1,1,1,2,1,1,1,1,1,1
1,1,1,2,1,1,1,1,1,1
1,1,1,2,1,1,1,1,1,1
1,1,1,2,2,2,X,1,1,1
1,1,1,1,1,1,1,1,1,1
